{
    "mapStr" : [
        "################",
        "################",
        "################",
        "#...#...#.######",
        "###.#.#.#.######",
        "###H#H#H#H######",
        "###.#.#.#.######",
        "###...#...######",
        "################",
        "################",
        "################",
        "################",
        "################",
        "################",
        "################",
        "################",
        "################",
        "################",
        "################",
        "################",
        "################",
        "################",
        "################",
        "################"
    ],
    "playerX": 1,
    "playerY": 3,
    "goalX": 9,
    "goalY": 3,
    "playerD" : "right",
    "maxBlock": 15
}