{
    "mapStr" : [
        "################",
        "################",
        "################",
        "################",
        "################",
        "################",
        "################",
        "################",
        "################",
        "################",
        "####....H...####",
        "################",
        "################",
        "################",
        "################",
        "################",
        "################",
        "################",
        "################",
        "################",
        "################",
        "################",
        "################",
        "################"
    ],
    "playerX": 4,
    "playerY": 10,
    "goalX": 11,
    "goalY": 10,
    "playerD" : "right"
}