{
    "mapStr" : [
        "################",
        "################",
        "################",
        "##..H.##########",
        "#####.##########",
        "#####.####....##",
        "###.H.####.#####",
        "###.####HH.#####",
        "###H######H#####",
        "###.######.#####",
        "##.....H...#####",
        "##########H#####",
        "##########.#####",
        "################",
        "################",
        "################",
        "################",
        "################",
        "################",
        "################",
        "################",
        "################",
        "################",
        "################"
    ],
    "playerX": 2,
    "playerY": 3,
    "goalX": 13,
    "goalY": 5,
    "playerD" : "right",
    "maxBlock":14
}